04
assets/sounds/02_music.wav
models/03/floor
#########
#gf c F #
#F+c+c+f#
# cfcF  #
#c+c+c+F#
# c c c #
# + +c+f#
#c ^  c #
# +c+ +F#
#>   ^> #
#c+ + +f#
#>  c   #
#c+ +c+ #
#> ^   p#
#########
