05
assets/sounds/02_music.wav
models/04/floor
#########
#gf c   #
#F c+c+c#
# cFcfc #
#c+c+c+c#
# cfcFc #
#^+c+c+ #
#c ^    #
#c+c+ + #
#>   ^ ^#
#c+c+f+ #
#>      #
#c+c+ +f#
# c   Fp#
#########
