06
assets/sounds/03_music.wav
models/04/floor
#############
#g>       F #
#++++++++++c#
#>      F + #
#c+++++++ + #
# +>  Fc+c+ #
# +c+++ + + #
#^+^+p+^+^+^#
# + + fc+ + #
# + +++++c+ #
# +>    f + #
# +++++++++c#
#>        f #
#############
