06
assets/sounds/03_music.wav
models/04/floor

+++++++++++++++
+ccccccccccccc+
+c+++++++++++c+
+g F F F F  +c+
++fffFf f f +c+
+F f FF+ F  +c+
++f f FFf+f +c+
++++++++++  +c+
++f   f f f++c+
+F f F   F +cc+
++f ^ F^f f+c++
+F F F   F +c++
+ f+ +f f f+cc+
+ +++++++++++c+
+ p          c+
+++++++++++++++