07
assets/sounds/03_music.wav
models/03/floor

+++++++++
+ + + + +
+ + + + +
+ + + + +
+ F +^F +
+^+ + + +
+p+^+ +	+
+ + +^+	+
+ + + +^+
+ +^+ +	+
+ + +^+	+
+ + + +^+++++
+ +^F + c g +
+^+ +^+ +++++
+ + + + +
+ +^+ + +
+++++++++