07
assets/sounds/03_music.wav
models/03/floor

#######################
#< p <                #
#++++++++++++++++F+####
#f +++   ++   ++   #
#f +ff c ff c ff c #
#F ff+* *++* *++* *#
#F^#################
#f #
#f #
#F^#
#Fg#
####