07
assets/sounds/03_music.wav
models/03/floor
#########
#gf    >#
#F+ + + #
#>  F  ^#
# +F+f+ #
#^  f  >#
# + + + #
#c ^   >#
# + + + #
#>  f^  #
#c+F+f+ #
#>  F   #
# + + +F#
#     fp#
#########
