end
assets/sounds/game_win.wav
models/01/floor
#################################
# cc    cc   ccc    cc     cc   #
#  cc  cc   cc cc   cc     cc   #
#   cccc   cc   cc  cc     cc   #
#    cc   cc     cc cc     cc   #
#    cc   cc     cc cc     cc   #
#    cc    cc   cc   cc   cc    #
#    cc     cc cc     cc cc     #
#    cc      ccc       ccc      #
#                               #
#   p                         g #
#                               #
# cc   ccc   cc  cc  cc      cc #
# cc   ccc   cc  cc  ccc     cc #
# cc   ccc   cc  cc  cc cc   cc #
# cc   ccc   cc  cc  cc  cc  cc #
# cc   ccc   cc  cc  cc   cc cc #
#  cc cc cc cc   cc  cc    cccc #
#   ccc   ccc    cc  cc     ccc #
#################################
